SITE,case,ems,moi,ran,total
1,24,28,48,48,148
2,18,34,33,36,121
3,40,30,51,73,194
4,27,44,54,54,179
5,11,17,13,22,63
6,23,32,46,46,147
7,42,58,83,84,267
8,57,66,114,114,351
9,22,26,44,44,136
10,36,50,72,72,230
11,36,62,70,72,240
12,14,22,26,28,90
13,36,48,53,60,197
14,21,16,42,42,121
15,46,56,92,91,285
16,53,67,103,106,329
17,34,46,68,68,216
